11111111111111
1C1E000CC0P001
11111111111111
