11111111111111
1P1E000CC0C001
11111111111111
