11111111111111
1E10000CC0P001
11111111111111
