11111111111111
110000CCE0P001
11111111111111
