11111111111111
1E0G000CC0P001
11111111111111
