111111
1111111111
101111
1CEP01
111
111111
