1111111111111111111
1CCCCP1CCCCC1CCCCC1
1C1111111C1111111C1
1CCCCCCC1C1CCCCCCC1
1111111C1C1C1111111
1CCCCC1CCCCC1CCCCC1
1C1111111C1111111C1
1CCC1CCCCCCCCC1CCC1
1C11111C111C11111C1
1CCCCCCC101CCCCCCC1
1C11111C111C11111C1
1CCC1CCCCCCCCC1CCC1
1C1111111C1111111C1
1CCCCC1CCCCC1CCCCC1
1111111CCCCC1111111
1CCCCCCC1C1CCCCCCC1
1C1111111C1111111C1
1CCCCC1CCCCC1ECCCC1
1111111111111111111
