11111111111111111
1P000000G000000C1
1G00000CCC0000111
1000C1100000000E1
11111111111111111
